8 8
1 1 1 1 1 1 s 1
0 0 0 1 0 1 0 1
0 1 0 0 0 0 0 1
0 1 1 1 1 1 0 1
0 0 0 0 1 0 0 1
0 1 1 p 1 1 0 1
0 0 0 1 0 0 0 1
1 1 0 1 1 0 1 1