5 5
0 0 1 s 1
1 0 1 0 0
0 0 1 0 1
1 0 0 0 0
p 0 1 0 1